**********************
*....................*
*....................*
*....................*
*.....g.......a.....@d
*....................*
*....................*
*....k........x......*
*....................*
*....................*
*.............c......*
*....................*
*....................*
**********************
entities

ground 0 255 0
door d 0 door.txt test_map2.txt
chest c chest.txt
chest k chest2.txt
npc x "Wise Old Man" wise_old_man.txt
door a 0 door2.txt
npc g "Goblin" goblin.txt