**********************
*....................*
*....................*
d@...................*
*....................*
**********************
entities

ground 50 50 50
door d 0 "" test_map.txt