**********************
*....................*
*....................*
*....................*
*...................@d
*....................*
*....................*
*.............x......*
*....................*
*....................*
*.............c......*
*....................*
*....................*
**********************
entities

ground 0 255 0
door d 0 door.txt test_map2.txt
chest c "Key" 1
npc x "Wise Old Man" village_chief_start